-----------??
------------?
---@@@@------
---@--??-???-
---@--???????
---@--?-??---
------????-~~
---?--???--~~
--??---------
-------------